R 1000 1000
NO brick.xpm
SO dirt.xpm
EA stone.xpm
WE wood.xpm

S sanic.xpm

C 254,36,98
F 7,32,154



11111111111111111111111111
10000000000111000000000001
10000000000000000000000001
10000000000000000000000001
100000000000100E0000000001
11000000000101000000000011
10000000000010000000000001
10000000000000000000000001
10000000000000000000000001
10000000000010000000000001
11111111111111111111111111





boot
