

R 1920 -9874


NO Makefile


SO Makefile

EA Makefile
WE Makefile

S Makefile

C 254,36,98
F 7,32,154



111111
101221111
1221100101
122110011
1111111111111111111





boot
