R 1920 1080
NO /toor/avengers/fr.jpg

SO /root/tree/leaf/soul.txt
EA /north/kanye/west/south.HALLO
WE /coucou/wrong/path/but/good.png

S ./your/mother/drink/sprite/samer.png

C 254,36,98
F 7,32,154



111111
100221111
1201000001
10000000001
1111111111111111111





boot
