R 1920 1080
NO /toor/avengers/fr.jpg
SO /root/tree/leaf/soul.txt
EA /north/kanye/west/south.HALLO
WE /coucou/wrong/path/but/good.png

S ./your/mother/drink/sprite/samer.png

F 7,32,154



1   1 1 1   1   1
101221
1                                      2211 00101
1111111111111111111





boot
